XX111111111111111111111111111111111111111111111111111111111XX
X10000000000000000000000000000000000000000000000000000000001X
X10000000000000000000000000000000000000000000000000000000001X
X10000000000000000000000000000000000000000000000000000000001X
X10000000000000000000000000000000000000000000000000000000001X
X10000000000000000000000000000000000000000000000000000000001X
X10000000000000000000000000000000000000000000000000000000001X
X10000000000000000000000000000000000000000000000000000000001X
X10000000000000000000000000000000000000000000000000000000001X
X10000000000000000000000000000000000000000000000000000000001X
X10000000000000000000000000000000000000000000000000000000001X
X10000000000000000000000000000000000000000000000000000000001X
X10000000000000000000000000000000000000000000000000000000001X
X10000000000000000000000000000000000000000000000000000000001X
X10000000000000000000000000000000000000000000000000000000001X
X10000000000000000000000000000000000000000000000000000000001X
X10000000000000000000000000000000000000000000000000000000001X
X10000000000000000000000000000000000000000000000000000000001X
X10000000000000000000000000000000000000000000000000000000001X
X10000000000000000000000000000000000000000000000000000000001X
X10000000000000000000000000000000000000000000000000000000001X
X10000000000000000000000000000000000000000000000000000000001X
X10000000000000000000000000000000000000000000000000000000001X
X10000000000000000000000000000000000000000000000000000000001X
X10000000000000000000000000000000000000000000000000000000001X
X10000000000000000000000000000000000000000000000000000000001X
X10000000000000000000000000000000000000000000000000000000001X
X10000000000000000000000000000000000000000000000000000000001X
X10000000000000000000000000000000000000000000000000000000001X
X10000000000000000000000000000000000000000000000000000000001X
X10000000000000000000000000000000000000000000000000000000001X
XX111111111111111111111111111111111111111111111111111111111XX