XX111111111111111111111111111111111111111111111111111111111XX
X10000000000000000000000000000000000000000000000000000000001X
X10000000000000000000000000000000000000000000000000000000001X
X10000000000000000000000000000000000000000000000000000000001X
X10000001111111111000000000000000000000000011111111110000001X
X10000001100000000000000000000000000000000000000000110000001X
X10000001100000000000000000000000000000000000000000110000001X
X10000001100000000000000000000000000000000000000000110000001X
X10000001100000000000000000000000000000000000000000110000001X
X10000000000000000000000000001100000000000000000000000000001X
X10000000000000000000000000001100000000000000000000000000001X
X10000000000000000000000000001100000000000000000000000000001X
X10000000000000000000000000001100000000000000000000000000001X
X10000000000000000000000000001100000000000000000000000000001X
X10000000000000000000000000001100000000000000000000000000001X
X1000000000000000000111111111XX11111111110000000000000000001X
X10000000000000000000000000001100000000000000000000000000001X
X10000000000000000000000000001100000000000000000000000000001X
X10000000000000000000000000001100000000000000000000000000001X
X10000000000000000000000000001100000000000000000000000000001X
X10000000000000000000000000001100000000000000000000000000001X
X10000000000000000000000000001100000000000000000000000000001X
X10000000000000000000000000000000000000000000000000000000001X
X10000000000000000000000000000000000000000000000000000000001X
X10000001100000000000000000000000000000000000000000110000001X
X10000001100000000000000000000000000000000000000000110000001X
X10000001100000000000000000000000000000000000000000110000001X
X10000001100000000000000000000000000000000000000000110000001X
X10000001111111111000000000000000000000000011111111110000001X
X10000000000000000000000000000000000000000000000000000000001X
X10000000000000000000000000000000000000000000000000000000001X
XX111111111111111111111111111111111111111111111111111111111XX